1111111111
1000000001
1111100111
1000101111
1010100001
1010110001
1$10101001
1100001001
1001111001
1001000001
1001000001
1001110001
1000010001
1000000001
1111111111
