1111111111
1000000001
1000000111
1000001111
1100000001
1111100001
1$00101001
1100001001
1101111001
1001000001
1001000001
1001110001
1000010001
1000000001
1111111111
