1111111111
1000000001
1000000111
1000001111
1000000001
1111111101
1$00101001
1100001001
1101111001
1001010001
1001000001
1100010001
1010010001
1000000001
1111111111